//MAP CONVERTED BY dmm2tgm.py THIS HEADER COMMENT PREVENTS RECONVERSION, DO NOT REMOVE
"a" = (
/obj/structure/inflatable/survival,
/turf/simulated/floor/pod)
"b" = (
/obj/structure/sign/mining/survival{
	icon_state = "survival";
	dir = 1
	},
/obj/structure/inflatable/survival)
"c" = (
/obj/structure/fans,
/turf/simulated/floor/pod,
/area/survivalpod{
	icon_state = "survival"
	})
"d" = (
/obj/structure/inflatable/survival,
/turf/simulated/floor/pod)

(1,1,1) = {"
a
b
d
"}
(2,1,1) = {"
a
c
d
"}
(3,1,1) = {"
a
b
c
"}